#####################
# A                 #
# ## ## ## ### #### #
# ## ## ## ### #### #
# ## ## ########### #
# ## ## ###         #
# ## ## ### #   #   #
# ## ## ### # # #   #
# ## ## ### # ### # #
# ## ## ###   ### # #
# ## ## ########### #
#     ############# #
##B#              # #
#################   #
#####################